adjective:
     Northwest	Northwest
     Southwest	Southwest
     West	West
     acer	acer
     after	after
     best	good
     better	good
     bluer	blue
     bluest	blue
     bother	bother
     bounder	bounder
     bower	bower
     cagier	cagey
     cagiest	cagey
     canter	canter
     cer	cer
     clever	clever
     cleverer	clever
     cleverest	clever
     cracker	cracker
     crueller	cruel
     cruellest	cruel
     darker	dark
     darkest	dark
     dicier	dicey
     diciest	dicey
     dopier	dopey
     dopiest	dopey
     easter	easter
     eerier	eerie
     eeriest	eerie
     elder	elder
     eldest	eldest
     farther	far
     farthest	far
     firmer	firm
     firmest	firm
     forest	forest
     fu'	full
     further	far
     furthest	far
     gooier	gooey
     gooiest	gooey
     halfways	halfway
     harder	hard
     hardest	hard
     holy       holy
     homer	homer
     homier	homey
     homiest	homey
     infringer	infringe
     interest	interest
     lander	lander
     layer	layer
     leer	leer
     ler	ler
     liter	liter
     liver	liver
     masterfu'	masterful
     matter	matter
     miser	miser
     modest	modest
     norther	norther
     northwest	northwest
     number	number
     only       only
     owner	owner
     passer	passer
     pater	pater
     poster	poster
     renter	renter
     shorter	short
     shortest	short
     smarter	smart
     smartest	smart
     souther	souther
     southwest	southwest
     stranger	strange
     strangest	strange
     swagger	swagger
     toper	toper
     trader	trader
     truer	true
     truest	true
     vest	vest
     warmer	warm
     warmest	warm
     west	west
     worse	bad
     worst	bad
adverb:
     alwayes	always
     always	always
     best	well
     better	well
     deeper	deeply
     earlier	early
     early	early
     farther	far
     faster	fast
     fastest	fast
     further	far
     harder	hard
     hardest	hard
     higher	high
     later	later
     lower	low
     n't	not
     nearer	near
     only       only
     slower	slow
     slowest	slow
     to-night   tonight
     wholly     whole
     wholy      whole
     worse	badly
conjunction:
     cos	because
     coz	because
infinitive-to:
     na	to
     ta	to
noun:
     Alps	Alps
     Archers	Archers
     Aussies	Aussie
     Cherubim	Cherub
     Chimerae	Chimera
     Commons	Commons
     Eumenides	Eumenides
     Hebrides	Hebrides
     Hibs	Hibs
     Indies	Indies
     Lords	Lords
     Narrows	Narrows
     Pyrenees	Pyrenees
     Rangers	Rangers
     Seraphim	Seraph
     Shadows	Shadows
     Spurs	Spurs
     Trossachs	Trossachs
     Wasps	Wasps
     Wolves	Wolves
     aardwolves	aardwolf
     abaci	abacus
     abscissae	abscissa
     acanthi	acanthus
     acari	acarus
     acciaccature	acciaccatura
     acetabula	acetabulum
     aciculae	acicula
     acini	acinus
     acre-feet	acre-foot
     acromia	acromion
     actiniae	actinia
     actinozoa	actinozoan
     addenda	addendum
     adenocarcinomata	adenocarcinoma
     adenomata	adenoma
     adieux	adieu
     aecia	aecium
     agnomina	agnomen
     agones	agon
     agorae	agora
     agouties	agouti
     aides-de-camp	aide-de-camp
     aides-memoire	aide-memoire
     alae	ala
     alewives	alewife
     algae	alga
     alkalies	alkali
     alluvia	alluvium
     altocumuli	altocumulus
     altostrati	altostratus
     alulae	alula
     alumnae	alumna
     alumni	alumnus
     alveoli	alveolus
     amanuenses	amanuensis
     ambulacra	ambulacrum
     amebae	ameba
     amends	amends
     amnia	amnion
     amniocenteses	amniocentesis
     amoebae	amoeba
     amoebiases	amoebiasis
     amoraim	amora
     amphimixes	amphimixis
     amphioxi	amphioxus
     amphisbaenae	amphisbaena
     amphorae	amphora
     ampullae	ampulla
     amygdalae	amygdala
     anacolutha	anacoluthon
     analyses	analysis
     anamneses	anamnesis
     anamorphoses	anamorphosis
     anastomoses	anastomosis
     ancones	ancon
     androecia	androecium
     andtheridia	antheridium
     angiomata	angioma
     animalcula	animalculum
     anlagen	anlage
     annuli	annulus
     antae	anta
     antefixa	antefix
     antennae	antenna
     antheridia	antheridium
     anthozoa	anthozoan
     anthraces	anthrax
     antiheroes	antihero
     antisera	antiserum
     antitheses	antithesis
     antra	antrum
     anus	anus
     aortae	aorta
     aphelia	aphelion
     aphides	aphis
     apices	apex
     apomixes	apomixis
     aponeuroses	aponeurosis
     apophyses	apophysis
     aposiopeses	aposiopesis
     apothecia	apothecium
     apotheoses	apotheosis
     apparatus	apparatus
     appendices	appendix
     appoggiature	appoggiatura
     apsides	apsis
     aquae	aqua
     aquaria	aquarium
     araglis	argali
     arboreta	arboretum
     arcana	arcanum
     archegonia	archegonium
     archesporia	archesporium
     archipelagoes	archipelago
     archivalia	archivalia
     arcs-boutants	arc-boutant
     areolae	areola
     ariette	arietta
     aristae	arista
     armamentaria	armamentarium
     arms	arm
     arrears	arrears
     arses	arsis
     artal	rotl
     artel	rotl
     arterioscleroses	arteriosclerosis
     asceses	ascesis
     asci	ascus
     ashkenazim	ashkenazi
     aspergilli	aspergillus
     aspergilloses	aspergillosis
     aspersoria	aspersorium
     assegais	assagai
     astragali	astragalus
     asyndeta	asyndeton
     atheromata	atheroma
     atheroscleroses	atherosclerosis
     atria	atrium
     auditoria	auditorium
     aurae	aura
     aurar	eyrir
     aurei	aureus
     auriculae	auricula
     aurorae	aurora
     auspices	auspex
#    auspices	auspices
     autocatalyses	autocatalysis
     autochthones	autochthon
     automata	automaton
     autos-da-fe	auto-da-fe
     avitaminoses	avitaminosis
     axes	axe
#    axes	axis
     axillae	axilla
     bacchantes	bacchant
     bacilli	bacillus
     bacteria	bacterium
     bacteriostases	bacteriostasis
     bains-marie	bain-marie
     ballistae	ballista
     bambini	bambino
     bandeaux	bandeau
     banditti	bandit
     bani	ban
     banjoes	banjo
     banns	banns
     bar-geese	bar-goose
     barramundies	barramundi
     bases	base
     bases-on-balls	base_on_balls
     basidia	basidium
     basileis	basileus
     bassi	basso
     bastinadoes	bastinado
     bateaux	bateau
     beaux	beau
     bee	bee
     beeves	beef
     bellows	bellows
     belongings	belongings
     bibliothecae	bibliotheca
     bicennaries	bicentenary
     bijoux	bijou
     bimboes	bimbo
     binocular	binoculars
     binoculars	binoculars
     blackfeet	blackfoot
     blandishments	blandishments
     blastemata	blastema
     blastulae	blastula
     blinkers	blinkers
     blitzes	blitz
     boleti	boletus
     bolivares	bolivar
     bolsheviki	bolshevik
     bongoes	bongo
     bonitoes	bonito
     bonuses	bonus
     booklice	booklouse
     bookshelves	bookshelf
     boraces	borax
     box-kodaks	box_kodak
     brachia	brachium
     brain-children	brain-child
     brainchildren	brainchild
     branchiae	branchia
     bravadoes	bravado
     bravoes	bravo
     bregmata	bregma
     brethren	brother
     bronchi	bronchus
     brothers-in-law	brother-in-law
     brussels	brussels
     bryozoa	bryozoan
     buboes	bubo
     buckteeth	bucktooth
     buffaloes	buffalo
     bullae	bulla
     bunde	bund
     bureaux	bureau
     bursae	bursa
     buses	bus
     busses	bus
     byssi	byssus
     cacti	cactus
     caducei	caduceus
     caeca	caecum
     caesurae	caesura
     calami	calamus
     calces	calx
     calculi	calculus
     calices	calix
     calicoes	calico
     calli	callus
     calves	calf
     calyces	calyx
     cambia	cambium
     camerae	camera
     canaliculi	canaliculus
     candelabra	candelabrum
     cannulae	cannula
     cantharides	cantharides
     canthi	canthus
     canulae	canula
     canvases	canvas
     capercaillies	capercaillie
     capita	caput
     capitula	capitulum
     capricci	capriccio
     carbonadoes	carbonado
     carcinomata	carcinoma
     cargoes	cargo
     carides	caryatid
     carinae	carina
     caroli	carolus
     carpi	carpus
     caryatides	caryatid
     caryopses	caryopsis
     caryopsides	caryopsis
     castrati	castrato
     cataloes	catalo
     catalyses	catalysis
     catenae	catena
     cathari	cathar
     cathexes	cathexis
     cattaloes	cattalo
     cattle	cattle
     caudices	caudex
     caules	caulis
     cavetti	cavetto
     ceca	cecum
     cellae	cella
     cembali	cembalo
     censuses	census
     centesimi	centesimo
     centra	centrum
     cercariae	cercaria
     cercariiae	cercaria
     cerci	cercus
     cerebella	cerebellum
     cerebra	cerebrum
     cervices	cervix
     chaetae	chaeta
     chalazae	chalaza
     challoth	hallah
     chamois	chamois
     chapaties	chapati
     chapatties	chapatti
     chapeaux	chapeau
     chasidim	chasid
     chassidim	chassid
     chassis	chassis
     chateaux	chateau
     chelae	chela
     chelicerae	chelicera
     cherubim	cherub
     chevaux-de-frise	cheval-de-frise
     chiasmata	chiasma
     chiasmi	chiasmus
     children	child
     chillies	chilli
     chlamydes	chlamys
     chlamyses	chlamys
     chondromata	chondroma
     choragi	choragus
     choruses	chorus
     choux	chou
     chrysalides	chrysalis
     cicadae	cicada
     cicale	cicala
     cicatrices	cicatrix
     ciceroni	cicerone
     cilia	cilium
     cimices	cimex
     cineraria	cinerarium
     cingula	cingulum
     circuses	circus
     cirri	cirrus
     cirrocumuli	cirrocumulus
     cirrostrati	cirrostratus
     ciscoes	cisco
     cisternae	cisterna
     claroes	claro
     clepsydrae	clepsydra
     clergy	clergy
     cliches	cliche
     clippers	clipper
     cloacae	cloaca
     clostridia	clostridium
     clothes	clothes
     cloverleaves	cloverleaf
     clypei	clypeus
     coagula	coagulum
     cocci	coccus
     coccyges	coccyx
     cochleae	cochlea
     codices	codex
     coelentera	coelenteron
     cognomina	cognomen
     cola	colon
     colloquia	colloquium
     collyria	collyrium
     colones	colon
     colossi	colossus
     columbaria	columbarium
     columellae	columella
     comae	coma
     comatulae	comatula
     comedones	comedo
     comics	comic_strip
     commandoes	commando
     commies	commie
     commons	commons
     compendia	compendium
     concerti	concerto
     conchae	concha
     condylomata	condyloma
     confervae	conferva
     congii	congius
     congratulations	congratulations
     conidia	conidium
     conjunctivae	conjunctiva
     conquistadores	conquistador
     consortia	consortium
     contents	content
     continua	continuum
     contralti	contralto
     convolvuli	convolvulus
     coolies	coolie
     copulae	copula
     coria	corium
     corneae	cornea
     cornua	cornu
     coronae	corona
     corpora	corpus
     corps	corps
     corrigenda	corrigendum
     cortices	cortex
     cortinae	cortina
     costae	costa
     country-folk	country-folk
     coxae	coxa
     crania	cranium
     credenda	credendum
     credentials	credentials
     crematoria	crematorium
     crescendi	crescendo
     crises	crisis
     cristae	crista
     criteria	criterion
     crossroads	crossroads
     cruces	crux
     crura	crus
     crying	cry
     cryings	cry
     ctenidia	ctenidium
     culices	culex
     culpae	culpa
     culti	cultus
     cumuli	cumulus
     cumulonimbi	cumulonimbus
     curiae	curia
     curies	curie
     curricula	curriculum
     customs	custom
     cutes	cutis
     cuticulae	cuticula
     cyclamen	cyclamen
     cyclopes	cyclops
     cycloses	cyclosis
     cylices	cylix
     cylikes	cylix
     cymae	cyma
     cymatia	cymatium
     dadoes	dado
     dagoes	dago
#    data	data
     data	datum
     datum	datum
     daughters-in-law	daughter-in-law
     decennia	decennium
     deciduae	decidua
     delphinia	delphinium
     deputies-elect	deputy-elect
     dermatoses	dermatosis
     desiderata	desideratum
     desperadoes	desperado
     diableries	diablerie
     diaereses	diaeresis
     diaerses	diaeresis
     diagnoses	diagnosis
     dialyses	dialysis
     diaphyses	diaphysis
     diarthroses	diarthrosis
     diastases	diastasis
     diastemata	diastema
     diathses	diathesis
     diazoes	diazo
     dibbukkim	dibbuk
     dice	dice
     dicta	dictum
     didoes	dido
     diereses	dieresis
     dieses	diesis
     differentiae	differentia
     dilettanti	dilettante
     dingoes	dingo
     diplococci	diplococcus
     disci	discus
     dive	diva
     diverticula	diverticulum
     divertimenti	divertimento
     djinn	djinni
     dodoes	dodo
     doe	doe
     dogmata	dogma
     dogteeth	dogtooth
     domatia	domatium
     dominoes	domino
     dormice	dormouse
     dorsa	dorsum
     drachmae	drachma
     drawknives	drawknife
     dregs	dregs
     drosophilae	drosophila
     dryades	dryad
     dues	dues
     dui	duo
     duona	duodenum
     duonas	duodenum
     dwarves	dwarf
     dybbukkim	dybbuk
     earnings	earnings
     ecchymoses	ecchymosis
     ecclesiae	ecclesia
     ecdyses	ecdysis
     echidnae	echidna
     echini	echinus
     echinococci	echinococcus
     echoes	echo
     ectozoa	ectozoan
     eddoes	eddo
     edemata	edema
     effluvia	effluvium
     eisegeses	eisegesis
     eisteddfodau	eisteddfod
     ellipses	ellipse
#    ellipses	ellipsis
     elves	elf
     elytra	elytron
     embargoes	embargo
     emboli	embolus
     emphases	emphasis
     emporia	emporium
     enarthroses	enarthrosis
     encephala	encephalon
     encephalitides	encephalitis
     enchiridia	enchiridion
     enchondromata	enchondroma
     encomia	encomium
     endamebae	endameba
     endamoebae	endamoeba
     endocardia	endocardium
     endocrania	endocranium
     endometria	endometrium
     endostea	endosteum
     endothelia	endothelium
     endozoa	endozoan
     enemata	enema
     entases	entasis
     entera	enteron
     entia	ens
     entozoa	entozoan
     entrails	entrails
     environs	environs
     epentheses	epenthesis
     ephemera	ephemeron
     ephemerae	ephemera
     ephemerides	ephemeris
     ephori	ephor
     epicalyces	epicalyx
     epicanthi	epicanthus
     epicardia	epicardium
     epididymides	epididymis
     epigastria	epigastrium
     epiglottides	epiglottis
     epiphenomena	epiphenomenon
     epiphyses	epiphysis
     epithelia	epithelium
     epitheliomata	epithelioma
     epizoa	epizoan
     equilibria	equilibrium
     equiseta	equisetum
     eringoes	eringo
     errata	erratum
     eryngoes	eryngo
     esophagi	esophagus
     etyma	etymon
     eucalypti	eucalyptus
     exanthemata	exanthema
     executrices	executrix
     exegeses	exegesis
     exordia	exordium
     exostoses	exostosis
     extrema	extremum
     eyeteeth	eyetooth
     faciae	facia
     faculae	facula
     fallings-off	falling-off
     famuli	famulus
     farragoes	farrago
     fasciae	fascia
     fasciculi	fasciculus
     fathers-in-law	father-in-law
     fatsoes	fatso
     faunae	fauna
     feculae	fecula
     fedayeen	fedayee
     feet	foot
     fellaheen	fellah
     fellahin	fellah
     femora	femur
     fenestellae	fenestella
     fenestrae	fenestra
     feriae	feria
     fezzes	fez
     fiascoes	fiasco
     fibrillae	fibrilla
     fibromata	fibroma
     fibulae	fibula
     ficoes	fico
     fieldmice	fieldmouse
     figs.	fig.
     fila	filum
     filariiae	filaria
     fimbriae	fimbria
     fishwives	fishwife
     fistulae	fistula
     flagella	flagellum
     flagstaves	flagstaff
     flambeaux	flambeau
     flamines	flamen
     flamingoes	flamingo
     flatfeet	flatfoot
     fleshpots	fleshpots
     fleurs-de-lis	fleur-de-lis
     fleurs-de-lys	fleur-de-lys
     florae	flora
     florilegia	florilegium
     flyleaves	flyleaf
     foci	focus
     focuses	focus
     focuses	focus
     folia	folium
     folk	folk
     fora	forum
     foramina	foramen
     forceps	forceps
     forefeet	forefoot
     formulae	formula
     fornices	fornix
     fortes	fortis
     fossae	fossa
     foveae	fovea
     frauen	frau
     frescoes	fresco
     fricandeaux	fricandeau
     frijoles	frijol
     frontes	frons
     frusta	frustum
     fry	fry
     fuci	fucus
     fulcra	fulcrum
     fundi	fundus
     funds	fund
     fungi	fungus
     funiculi	funiculus
     furculae	furcula
     furfures	furfur
     galeae	galea
     gallows	gallows
     gametangia	gametangium
     gametoecia	gametoecium
     ganglia	ganglion
     gas	gas
     gases	gas
     gasses	gas
     gastrulae	gastrula
     gateaux	gateau
     gazeboes	gazebo
     geckoes	gecko
     geese	goose
     gelsemia	gelsemium
     gemboks	gemsbok
     gembucks	gemsbuck
     gemmae	gemma
     genera	genus
     geneses	genesis
     genii	genius
     geniuses	genius
     gentes	gens
     gentlemen-at-arms	gentleman-at-arms
     genua	genu
     genus	genus
     germina	germen
     gestalten	gestalt
     ghettoes	ghetto
     gimbals	gimbals
     gingivae	gingiva
     gingkoes	gingko
     ginglymi	ginglymus
     ginkgoes	ginkgo
     glabellae	glabella
     gladioli	gladiolus
     glandes	glans
     glasses	glass
     gliomata	glioma
     glissandi	glissando
     globigerinae	globigerina
     glochidcia	glochidium
     glochidia	glochidium
     glomeruli	glomerulus
     glossae	glossa
     glottides	glottis
     glutei	gluteus
     gnoses	gnosis
     godchildren	godchild
     goes	go
     goings-over	going-over
     gonia	gonion
     gonococci	gonococcus
     goods	goods
     goyim	goy
     grafen	graf
     graffiti	graffito
     grandchildren	grandchild
     grandmothers-to-be	grandmother-to-be
     grants-in-aid	grant-in-aid
     granulomata	granuloma
     grassroot	grassroots
     grassroots	grassroots
     groszy	grosz
     grottoes	grotto
     guests-in-prison	guest-in-prison
     guilder	guilde
     guilders	guilde
     gummata	gumma
     gurnard	gurnar
     gurnards	gurnar
     guts	guts
     guttae	gutta
     gymnasia	gymnasium
     gynoecea	gynoecium
     gynoecia	gynoecium
     gyri	gyrus
     hadarim	heder
     hadjes	hadj
     haemarthroses	haemarthrosis
     haematolyses	haematolysis
     haematomata	haematoma
     haemodialyses	haemodialysis
     haemolyses	haemolysis
     haemoptyses	haemoptysis
     haeredes	haeres
     haftaroth	haftarah
     haggadoth	haggada
     hajjes	hajj
     haleru	haler
     half-lives	half-life
     hallot	hallah
     halloth	hallah
     halluces	hallux
     haloes	halo
     halteres	halter
     halves	half
     hangers-on	hanger-on
     haphtaroth	haphtarah
     haredim	haredi
     hasidim	hasid
     hassidim	hassid
     haustoria	haustorium
     head-scarves	head-scarf
     headaches	headache
     headquarters	headquarters
     headscarves	headscarf
     heirs-at-law	heir-at-law
     helices	helix
     heliozoa	heliozoan
     hematolyses	hematolysis
     hematomata	hematoma
     hemodialyses	hemodialysis
     hemolyses	hemolysis
     hemoptyses	hemoptysis
     herbaria	herbarium
     hermae	herm
     hermai	herma
     herniae	hernia
     heroes	hero
     herren	herr
     hila	hilum
     hili	hilus
     hippocampi	hippocampus
     hippopotami	hippopotamus
     his	his
     hoboes	hobo
     homunculi	homunculus
     honoraria	honorarium
     hooves	hoof
     housewives	housewife
     humanities	humanities
     humeri	humerus
     hydrae	hydra
     hydrozoa	hydrozoan
     hymenoptera	hymenopteran
     hynia	hymenium
     hyniums	hymenium
     hypanthia	hypanthium
     hyphae	hypha
     hypnoses	hypnosis
     hypochondria	hypochondrium
     hypophyses	hypophysis
     hypostases	hypostasis
     hypothalami	hypothalamus
     hypotheses	hypothesis
     hypotheses	hypothesis
     hyraces	hyrax
     iambi	iamb
     ibices	ibex
     ibo	igbo
     ichthyosauri	ichthyosaurus
     ichthyosauruses	ichthyosaur
     icosahedra	icosahedron
     ilia	ilium
     imagines	imago
     imagoes	imago
     impedimenta	impedimenta
     imperia	imperium
     impies	impi
     incubi	incubus
     incudes	incus
     indices	index
     indigenae	indigene
     indigoes	indigo
     indumenta	indumentum
     indusia	indusium
     infundibula	infundibulum
     innards	innards
     innings	innings
     innuendoes	innuendo
     inocula	inoculum
     insulae	insula
     intagli	intaglio
     interleaves	interleaf
     intermezzi	intermezzo
     interregna	interregnum
     intimae	intima
     involucra	involucre
     irides	iris
     irises	iris
     irs	irs
     is	is
     ischia	ischium
     isthmi	isthmus
     jackknives	jackknife
     jacks-in-the-box	jack-in-the-box
     jambeaux	jambeau
     jean	jeans
     jeans	jeans
     jingoes	jingo
     jinn	jinni
     joes	jo
     jura	jus
     keeshonden	keeshond
     kibbutzim	kibbutz
     kin	kin
     kine	cow
     kineses	kinesis
     kinfolk	kinfolk
     kith	kith
     knickers	knickers
     knives	knife
     kohlrabies	kohlrabi
     kronen	krone
     kroner	krone
     kronur	krona
     krooni	kroon
     kylikes	kylix
     labia	labium
     labra	labrum
     lactobacilli	lactobacillus
     lacunae	lacuna
     ladies-in-waiting	lady-in-waiting
     lamellae	lamella
     lamiae	lamia
     laminae	lamina
     larvae	larva
     larynges	larynx
     lassoes	lasso
     lati	lat
     latices	latex
     latu	lat
     lavaboes	lavabo
     leaves	leaf
     leges	lex
     lei	leu
     lemmata	lemma
     lemnisci	lemniscus
     lenes	lenis
     lentigines	lentigo
     leonides	leonid
     lepidoptera	lepidopteran
     lepta	lepton
     leptocephali	leptocephalus
     leucocytozoa	leucocytozoan
     leva	lev
     librae	libra
     libretti	libretto
     lice	louse
     lieder	lied
     ligulae	ligula
     limbi	limbus
     limina	limen
     limites	limes
     limuli	limulus
     lingoes	lingo
     linguae	lingua
     lipomata	lipoma
     lire	lira
     liriodendra	liriodendron
     listente	sente
     litai	lit
     litu	litas
     lives	life
     loaves	loaf
     loci	locus
     loculi	loculus
     lodgings	lodgings
     loggie	loggia
     logia	logion
     loricae	lorica
     lumbus	lumbi
     lumina	lumen
     lunulae	lunula
     lures	lur
     lustra	lustre
     lyings-in	lying-in
     lymphangitides	lymphangitis
     lymphomata	lymphoma
     lymphopoieses	lymphopoiesis
     lyses	lysis
     maare	maar
     macaronies	macaroni
     macrosporangia	macrosporangium
     maculae	macula
     madornos	madrono
     maestri	maestro
     mafiosi	mafioso
     magi	magus
     magmata	magma
     magpies	magpie
     mains	mains
     major-axes	major_axis
     makuta	likuta
     mallei	malleus
     maloti	loti
     mamillae	mamilla
     mammae	mamma
     mammillae	mammilla
     mangoes	mango
     manifestoes	manifesto
     manners	manner
     manteaux	manteau
     mantes	mantis
     manubria	manubrium
     markkaa	markka
     marsupia	marsupium
     marvels-of-peru	marvel-of-peru
     masters-at-arms	master-at-arms
     matrices	matrix
     matzoth	matzo
     mausolea	mausoleum
     maxillae	maxilla
     maxima	maximum
     mealies	mealie
     means	means
     measles	measles
     media	medium
     mediae	media
     mediastina	mediastinum
     medullae	medulla
     medusae	medusa
     megasporangia	megasporangium
     megilloth	megillah
     meioses	meiosis
     melanomata	melanoma
     mementoes	memento
     memorabilia	memorabilia
     memoranda	memorandum
     men-at-arms	man-at-arms
     men-o'-war	man-of-war
     men-of-war	man-of-war
     menfolk	menfolk
     menisci	meniscus
     menservants	manservant
     menstrua	menstruum
     mesdames	madame
     mesdemoiselles	mademoiselle
     messieurs	monsieur
     messrs	messrs
     mestizoes	mestizo
     metacarpi	metacarpus
     metamorphoses	metamorphosis
     metanauplii	metanauplus
     metastases	metastasis
     metatarsi	metatarsus
     metatheses	metathesis
     metazoa	metazoan
     metempsychoses	metempsychosis
     metencephala	metencephalon
     metropolises	metropolis
     mews	mews
     mewses	mews
     mezuzoth	mezuzah
     miasmata	miasma
     mice	mouse
     micrococci	micrococcus
     microsporangia	microsporangium
     midrashim	midrash
     midwives	midwife
     milia	milium
     milieux	milieu
     millenia	millenium
     millennia	millennium
     minae	mina
     minima	minimum
     minuses	minus
     minutiae	minutia
     minyanim	minyan
     mioses	miosis
     miri	mir
     mishnayoth	mishna
     miss	miss
     mistress	mistress
     mitochondria	mitochondrion
     mitzvoth	mitzvah
     mockers	mockers
     modioli	modiolus
     moduli	modulus
     moggies	moggie
     momenta	momentum
     momi	momus
     monades	monad
     monsignori	monsignor
     morae	mora
     moratoria	moratorium
     morceaux	morceau
     morphallaxes	morphallaxis
     morphoses	morphosis
     morulae	morula
     moshavim	moshav
     moslim	moslem
     moslims	moslem
     mosquitoes	mosquito
     mothers-in-law	mother-in-law
     mothers-to-be	mother-to-be
     mottoes	motto
     moustaches	moustache
     movies	movie
     mrs	mrs
     ms	ms
     mucosae	mucosa
     mucrones	mucro
     mulattoes	mulatto
     mumps	mumps
     muskallunge	muskellunge
     mycelia	mycelium
     mycobacteria	mycobacterium
     myelencephala	myelencephalon
     myiases	myiasis
     myocardia	myocardium
     myofibrillae	myofibrilla
     myomata	myoma
     myoses	myosis
     myrmidones	myrmidon
     myxomata	myxoma
     naiades	naiad
     narcissi	narcissus
     nares	naris
     nasopharynges	nasopharynx
     natatoria	natatorium
     naumachiae	naumachia
     nautili	nautilus
     navahoes	navaho
     navajoes	navajo
     nebulae	nebula
     necropoleis	necropolis
     negroes	negro
     nemeses	nemesis
     nereides	nereid
     neurohypophyses	neurohypophysis
     neuromata	neuroma
     neuroptera	neuropteron
     neuroses	neurosis
     nevi	nevus
     nibelungen	nibelung
     nidi	nidus
     nighties	nightie
     nimbi	nimbus
     noctilucae	noctiluca
     noes	no
     nomina	nomen
     non-kin	non-kin
     noumena	noumenon
     novae	nova
     novelle	novella
     novenae	novena
     nucelli	nucellus
     nuchae	nucha
     nuclei	nucleus
     nucleoli	nucleolus
     nulliparae	nullipara
     numina	numen
     nymphae	nympha
     oases	oasis
     oats	oats
     obligati	obligato
     oboli	obolus
     occipita	occiput
     oceanides	oceanid
     ocelli	ocellus
     octahedra	octahedron
     octopi	octopus
     octopodes	octopus
     oculi	oculus
     odds	odds
     oedemata	edema
     oesophagi	esophagus
     offspring	offspring
     oldwives	oldwife
     olea	oleum
     omasa	omasum
     omayyades	omayyad
     omenta	omentum
     ommatidia	ommatidium
     ommiades	ommiad
     onagri	onager
     opercula	operculum
     optima	optimum
     ora	os
     organa	organon
     organums	organa
     orthoptera	orthopteron
     osar	os
     ossa	os
     osteomata	osteoma
     ostia	ostium
     ottomans	othman
     outskirts	outskirts
     ova	ovum
     overalls	overall
     ovoli	ovolo
     ovotestes	ovotestis
     oxen	ox
     oxymora	oxymoron
     pains	pain
     paise	paisa
     pajama	pajamas
     pajamas	pajamas
     paleae	palea
     palestrae	palestra
     palingeneses	palingenesis
     pallia	pallium
     palmettoes	palmetto
     pantaloons	pantaloons
     pants	pants
     paparazzi	paparazzo
     paperknives	paperknife
     papillae	papilla
     papillomata	papilloma
     pappi	pappus
     papyri	papyrus
     paraleipses	paraleipsis
     paralyses	paralysis
     paramecia	paramecium
     paraphernalia	paraphernalia
     paraphyses	paraphysis
     parapodia	parapodium
     parapraxes	parapraxis
     parazoa	parazoan
     parentheses	parenthesis
     parhelia	parhelion
     parietes	paries
     paris-mutuels	pari-mutuel
     particulars	particulars
     passers-by	passer-by
     pastorali	pastorale
     patellae	patella
     patinae	patina
     patois	patois
     patresfamilias	paterfamilias
     pease	pea
     peccadilloes	peccadillo
     pectines	pecten
     pedes	pes
     pekingese	pekinese
     pelves	pelvis
     pelvises	pelvis
     pence	penny
     penes	penis
     penetralium	penetralia
     penicillia	penicillium
     penknives	penknife
     pennae	penna
     pennia	penni
     pennies-in-the-slot	penny-in-the-slot
     pentahedra	pentahedron
     pentimenti	pentimento
     penumbrae	penumbra
     people	people
     pepla	peplum
     pericardia	pericardium
     peridia	peridium
     perigonia	perigonium
     perihelia	perihelion
     perinea	perineum
     periostea	periosteum
     periphrases	periphrasis
     peristalses	peristalsis
     perithecia	perithecium
     peritonea	peritoneum
     personae	persona
     personnel	personnel
     petechiae	petechia
     pfennige	pfennig
     phalli	phallus
     pharynges	pharynx
     phenomena	phenomenon
     philodendra	philodendron
     phyla	phylum
     phylae	phyle
     phylloxerae	phylloxera
     phylogeneses	phylogenesis
     pieds-a-terre	pied-a-terre
     pilei	pileus
     pincer	pincers
     pincers	pincers
     pineta	pinetum
     pinkfeet	pinkfoot
     pinkoes	pinko
     pinnae	pinna
     pinnulae	pinnula
     pirogi	pirog
     pithecanthropi	pithecanthropus
     placeboes	placebo
     placentae	placenta
     planetaria	planetarium
     planulae	planula
     plasmodia	plasmodium
     plateaux	plateau
     plectra	plectron
     plena	plenum
     pleura	pleuron
     pleurae	pleura
     plicae	plica
     pluses	plus
     pneumococci	pneumococcus
     pocketknives	pocketknife
     podetia	podetium
     podia	podium
     podia	podium
     poleis	polis
     police	police
     pollices	pollex
     pollinia	pollinium
     polyhedra	polyhedron
     polypi	polypus
     polyzoa	polyzoan
     pontes	pons
     pontifices	pontifex
     porticoes	portico
     portmanteaux	portmanteau
     potatoes	potato
     pp	p
     pp	p
     praenomina	praenomen
     praxes	praxis
     premises	premise
     prese	presa
     primi	primo
     primigravidae	primigravida
     primiparae	primipara
     primordia	primordium
     princess	princess
     prisoners-of-war	prisoner-of-war
     proboscides	proboscis
     prognoses	prognosis
     prolegomena	prolegomenon
     prolepses	prolepsis
     promycelia	promycelium
     pronuclei	pronucleus
     propositi	propositus
     proscenia	proscenium
     prosencephala	prosencephalon
     prostheses	prosthesis
     prothalamia	prothalamion
     prothoraces	prothorax
     protozoa	protozoan
     provisoes	proviso
     psalteria	psalterium
     pseudopodia	pseudopodium
     psychoneuroses	psychoneurosis
     psychoses	psychosis
     pterygia	pterygium
     ptoses	ptosis
     pubes	pubis
     public-relations	public-relations
     public-relations	public-relations
     pudenda	pudendum
     puli	pul
     pupae	pupa
     putamina	putamen
     pycnidia	pycnidium
     pyjama	pyjamas
     pyjamas	pyjamas
     pylori	pylorus
     pyxides	pyxis
     pyxidia	pyxidium
     quadrennia	quadrennium
     quanta	quantum
     quarterstaves	quarterstaff
     quinquennia	quinquennium
     quizzes	quiz
     rachides	rhachis
     radices	radix
     radii	radius
     rami	ramus
     ranulae	ranula
     ranunculi	ranunculus
     raphae	raphe
     reales	real
     recta	rectum
     recti	rectus
     rediae	redia
     referenda	referendum
     regalia	regalia
     regards	regards
     reguli	regulus
     reis	real
     relata	relatum
     remains	remains
     rendezvous	rendezvous
     reseaux	reseau
     residua	residuum
     retia	rete
     reticula	reticulum
     retinae	retina
     reveries	reverie
     rhabdomyomata	rhabdomyoma
     rhachides	rhachis
     rhachises	rachis
     rhinencephala	rhinencephalon
     rhizobia	rhizobium
     rhombi	rhombus
     rhonchi	rhonchus
     riches	riches
     rickets	rickets
     rickettsiae	rickettsia
     rilievi	rilievo
     rimae	rima
     robes-de-chambre	robe-de-chambre
     roma	rom
     rondeaux	rondeau
     rostra	rostrum
     rouleaux	rouleau
     rugae	ruga
     rumina	rumen
     runners-up	runner-up
     sacra	sacrum
     salespeople	salesperson
     salmonellae	salmonella
     salpae	salpa
     salpinges	salpinx
     salvoes	salvo
     sancta	sanctum
     sanitaria	sanitarium
     santimi	santims
     saphenae	saphena
     sarcophagi	sarcophagus
     sartorii	sartorius
     savings	saving
     scaleni	scalenus
     scales	scale
     scapulae	scapula
     scarabaei	scarabaeus
     scarves	scarf
     schemata	schema
     scherzi	scherzo
     schmoes	schmo
     schuln	schul
     schutzstaffeln	schutzstaffel
     scissor	scissors
     scissors	scissors
     scleroses	sclerosis
     sclerotia	sclerotium
     scoriae	scoria
     scotomata	scotoma
     scriptoria	scriptorium
     scrota	scrotum
     scudi	scudo
     scyphi	scyphus
     scyphozoa	scyphozoan
     secondi	secondo
     segni	segno
     selves	self
     senores	senor
     senti	sent
     separatrices	separatrix
     sephardim	sephardi
     septa	septum
     sequelae	sequela
     sera	serum
     sera	serum
     seraphim	seraph
     series	series
     setae	seta
     sgraffiti	sgraffito
     shakoes	shako
     sheaves	sheaf
     shelves	shelf
     shingles	shingles
     shinleaves	shinleaf
     shittim	shittah
     shmoes	shmo
     shofroth	shofar
     shophroth	shophar
     shorts	shorts
     shrewmice	shrewmouse
     shuln	shul
     signore	signora
     signori	signior
     signorine	signorina
     siliquae	siliqua
     silvae	silva
     simulacra	simulacrum
     sincipita	sinciput
     sisters-in-law	sister-in-law
     solaria	solarium
     soles	sol
     solfeggi	solfeggio
     soli	solo
     solidi	solidus
     somata	soma
     sons-in-law	son-in-law
     soprani	soprano
     sordini	sordino
     sori	sorus
     sorties	sortie
     spadices	spadix
     species	species
     spectacle	spectacle
     spectacles	spectacle
     spectra	spectrum
     specula	speculum
     spermatozoa	spermatozoon
     sphinges	sphinx
     spicae	spica
     spicula	spiculum
     spirilla	spirillum
     spirits	spirit
     splayfeet	splayfoot
     splenii	splenius
     sporangia	sporangium
     sporozoa	sporozoan
     sputa	sputum
     squamae	squama
     squillae	squilla
     stadia	stadium
     stair	stairs
     stairs	stairs
     stamina	stamen
     stapedes	stapes
     staphylococci	staphylococcus
     startsy	starets
     state-police	state-police
     staves	staff
     stelae	stele
     stemmata	stemma
     stenoses	stenosis
     step-children	step-child
     stepchildren	stepchild
     sterna	sternum
     stigmata	stigma
     stimuli	stimulus
     stipites	stipes
     stoae	stoa
     stomata	stoma
     stotinki	stotinka
     stotkini	stotinka
     strappadoes	strappado
     strata	stratum
     strati	stratus
     streptococci	streptococcus
     striae	stria
     strobili	strobilus
     stromata	stroma
     strumae	struma
     stuccoes	stucco
     styli	stylus
     stylopodia	stylopodium
     subgenera	subgenus
     submatrices	submatrix
     submucosae	submucosa
     subphyla	subphylum
     substrasta	substratum
     succedanea	succedaneum
     succubi	succubus
     sudatoria	sudatorium
     sulci	sulcus
     summae	summa
     summonses	summons
     supercargoes	supercargo
     supernovae	supernova
     superstrata	superstratum
     surroundings	surroundings
     suspender	suspenders
     suspenders	suspenders
     swamies	swami
     syconia	syconium
     syllabi	syllabus
     syllabuses	syllabus
     syllepses	syllepsis
     symphyses	symphysis
     symposia	symposium
     synapses	synapsis
     syncytia	syncytium
     synopses	synopsis
     syntagmata	syntagma
     syntheses	synthesis
     syringes	syrinx
     systems	system
     tableaux	tableau
     taeniae	taenia
     tali	talus
     tallaisim	tallith
     tallithes	tallith
     tallitoth	tallith
     tarantulae	tarantula
     tarsi	tarsus
     tatties	tattie
     taxa	taxon
     taxies	taxi
     tea-leaves	tea-leaf
     teeth	tooth
     telae	tela
     telamones	telamon
     telia	telium
     tempi	tempo
     tenderfeet	tenderfoot
     teniae	tenia
     tenterhooks	tenterhooks
     tenues	tenuis
     terata	teras
     teredines	teredo
     termini	terminus
     terraria	terrarium
     terzetti	terzetto
     tesserae	tessera
     testae	testa
     testes	testis
     testudines	testudo
     tetrahedra	tetrahedron
     tetraskelia	tetraskelion
     thalami	thalamus
     thalli	thallus
     thanks	thanks
     thecae	theca
     therses	thyrse
     thesauri	thesaurus
     theses	thesis
     thieves	thief
     thoraces	thorax
     thrombi	thrombus
     thymi	thymus
     thyrsi	thyrsus
     tibiae	tibia
     time-series	time-series
     titmice	titmouse
     tobaccoes	tobacco
     tomatoes	tomato
     tomenta	tomentum
     tophi	tophus
     topoi	topos
     tori	torus
     tornadoes	tornado
     torpedoes	torpedo
     torsi	torso
     townfolk	townfolk
     townsfolk	townsfolk
     townspeople	townspeople
     trabeculae	trabecula
     tracheae	trachea
     tragi	tragus
     trapezia	trapezium
     trapezohedra	trapezohedron
     traumata	trauma
     treponemata	treponema
     trichinae	trichina
     triclinia	triclinium
     triskelia	triskelion
     triumviri	triumvir
     trivia	trivium
     trochleae	trochlea
     tropaeola	tropaeolum
     tropics	tropics
     trous-de-loup	trou-de-loup
     trouser	trousers
     trousers	trousers
     trousseaux	trousseau
     trymata	tryma
     tubae	tuba
     turps	turps
     turves	turf
     tweezer	tweezers
     tweezers	tweezers
     tympana	tympanum
     tyros	tiro
     ubermenschen	ubermensch
     uglies	ugli
     uigurs	uighur
     ulnae	ulna
     ultimata	ultimatum
     umbilici	umbilicus
     umbones	umbo
     umbrae	umbra
     unci	uncus
     underpants	underpants
     urethrae	urethra
     urinalyses	urinalysis
     uteri	uterus
     utriculi	utriculus
     uvulae	uvula
     vacua	vacuum
     vagi	vagus
     vaginae	vagina
     valleculae	vallecula
     valuables	valuables
     varices	varix
     vasa	vas
     vela	velum
     venae	vena
     ventriculi	ventriculus
     vermes	vermis
     verrucae	verruca
     vertebrae	vertebra
     vertices	vertex
     vertigines	vertigo
     vertigoes	vertigo
     vesicae	vesica
     vetoes	veto
     viatores	viator
     vibrissae	vibrissa
     villi	villus
     viragoes	virago
     vires	vis
     virtuosi	virtuoso
     viruses	virus
     viscera	viscera
     vitae	vita
     vitelli	vitellus
     vittae	vitta
     vivaria	vivarium
     voces	vox
     volcanoes	volcano
     volte	volta
     volvae	volva
     vorticellae	vorticella
     vortices	vortex
     vulvae	vulva
     vv	v
     wagons-lits	wagon-lit
     wahhabis	wahabi
     washers-up	washer-up
     werewolves	werewolf
     wharves	wharf
     whereabouts	whereabouts
     whippers-in	whipper-in
     withers	withers
     wives	wife
     wolves	wolf
     womenfolk	womenfolk
     wood-lice	wood-louse
     woodlice	woodlouse
     work-people	work-people
     workpeople	workpeople
     works	work
     yeshivahs	yeshiva
     yeshivoth	yeshiva
     yogin	yogi
     zeroes	zero
     zoa	zoon
     zoonoses	zoonosis
preposition:
     na	to
     nearer	near
     nearest	near
     o'	of
     ta	to
pronoun-possessive-determiner:
	her	her
	his	his
	its	its
	mine	mine
	my	my
	one's	one's
	our	our
	their	their
	thine	thine
	thy	thy
	y'all's	your
	you	you
	your	your
pronoun-possessive:
	hers	she
	his	he
	mine	I
	ours	we
	theirs	they
	thine	thou
	yours	you
	y'all's	you
pronoun:
	'e	he
	'em	they
	'er	she
	'im	he
	't	it
	I	I
	eet	it
	he	he
	heem	he
	her	she
	herself	herself
	him	he
	himself	himself
	it	it
	itself	itself
	me	I
	myself	myself
	one	one
	oneself	oneself
	ourself	ourself
	ourselves	ourselves
	she	she
	t	it
	tha	thou
	thee	thou
	them	they
	themself	themself
	themselves	themselves
	they	they
	thou	thou
	thyself	thyself
	us	we
	we	we
	wee	we
	whom	who
	whomsoever	whosoever
	whose	who
	y'	you
	y'all	you
	ya	you
	ye	you
	yinz	you
	yis	you
	you	you
	your	you
	yourself	yourself
	yourselves	yourselves
	yous	you
	yuh	you
verb:
     'ave	have
     'd	have
     'd	will
     'll	will
     'm	be
     'n	than
     're	be
     's	be
     's	have
     've	have
     've	have
     a-calling	a-call
     a-dying	a-die
     a-readin'	a-read
     abided	abide
     abode	abide
     abought	aby
     abye	aby
     accurst	accurse
     accustomed	accustom
     ached	ache
     aching	ache
     added	add
     adding	add
     addrest	address
     adhered	adhere
     adhering	adhere
     alit	alight
     am	be
     anchoring	anchor
     arcked	arc
     arcking	arc
     are	be
     arisen	arise
     arose	arise
     arranging	arrange
     art	be
     ate	eat
     awed	awe
     awoke	awake
     awoken	awake
     axed	axe
     baby-sat	baby-sit
     backbit	backbite
     backbitten	backbite
     backslid	backslide
     backslidden	backslide
     bade	bid
     banged	bang
     basted	baste
     basting	baste
     be	be
     beat	beat
     beaten	beat
     became	become
     become	become
     bed	bed
     bee	be
     been	be
     been	be
     befallen	befall
     befell	befall
     began	begin
     begat	beget
     begirt	begird
     begot	beget
     begotten	beget
     beguiled	beguile
     begun	begin
     beheld	behold
     beholden	behold
     being	be
     belies	belie
     belonged	belong
     belying	belie
     bent	bend
     bequeathed	bequeath
     bereft	bereave
     beset	beset
     besought	beseech
     bespoke	bespeak
     bespoken	bespeak
     bestrewed	bestrew
     bestrewn	bestrew
     bestrid	bestride
     bestridden	bestride
     bestrode	bestride
     bet	bet
     betaken	betake
     bethought	bethink
     betook	betake
     betrothed	betroth
     biased	bias
     biassed	bias
     biassing	bias
     bid	bid
     bidden	bid
     bing	bing
     bit	bite
     biting	bite
     bitten	bite
     bivouacked	bivouac
     bivouacking	bivouac
     blanketed	blanket
     bled	bleed
     blest	bless
     blew	blow
     blossomed	blossom
     blown	blow
     bore	bear
     born	bear
#    born	born
     borne	bear
     bottle-fed	bottle-feed
     bought	buy
     bound	bind
     boycotted	boycott
     boycotting	boycott
     bracketed	bracket
     brang	bring
     breathing	breathe
     bred	breed
     bring	bring
     broadcast	broadcast
     broke	break
     broken	break
     brought	bring
     browbeat	browbeat
     browbeaten	browbeat
     brung	bring
     budgeted	budget
     built	build
     built-up	build-up
     bunged	bung
     burned	burn
     burnt	burn
#    burred	bur
     burred	burr
     burst	burst
     bust	bust
     butting	butt
     buzzes	buzz
     bypast	bypass
     ca	can
     caddied	caddie
     caddies	caddie
     caddying	caddie
     came	come
     camest	come
     can't	can
     canceled	cancel
     canceling	cancel
     canvassed	canvas
     canvassing	canvas
     carpeted	carpet
     carried-out	carry-out
     cast	cast
     caught	catch
     censored	censor
     centred	centre
     centring	centre
     challenging	challenge
     changing	change
     chevied	chivy
     chevies	chivy
     chevying	chivy
     chid	chide
     chidden	chide
     chivvied	chivy
     chivvies	chivy
     chivvying	chivy
     chode	chide
     chorused	chorus
     chorusing	chorus
     chose	choose
     chosen	choose
     cited	cite
     citing	cite
     clad	clothe
     clapt	clap
     cleft	cleave
     cling	cling
     closeted	closet
     clove	cleave
     cloven	cleave
     clung	cling
     co-ordinate	coordinate
     co-ordinated	coordinate
     co-ordinates	coordinate
     co-ordinating	coordinate
     coiffed	coif
     coiffing	coif
     colorbred	colorbreed
     colored	color
     combated	combat
     combating	combat
     come	come
     cometh	come
     comin'	come
     conceal'd	conceal
     condoned	condone
     containeth	contain
     contravened	contravene
     contravening	contravene
     convened	convene
     cosseted	cosset
     cosseting	cosset
     cost	cost
     could	can
     could	can
     couldest	can
     couldst	can
     countersank	countersink
     countersunk	countersink
     created	create
     creating	create
     crept	creep
     cringing	cringe
     crossbred	crossbreed
     curst	curse
     cut	cut
     d'	do
     daydreamt	daydream
     dealt	deal
     degassed	degas
     degasses	degas
     degassing	degas
     delayed	delay
     delineated	delineate
     dependin'	depend
     desir'd	desire
     destroyed	destroy
     developed	develop
     developing	develop
     dialled	dial
     dialling	dial
     did	do
     did	do
     didst	do
     dieth	die
     dight	dight
     ding	ding
     displayed	display
     disproved	disprove
     disproven	disprove
     dived	dive
     do	do
     doe	do
     does	do
     doing	do
     done	do
     done	do
     dost	do
     doth	do
     dought	dow
     dove	dive
     drank	drink
     drawing-in	draw-in
     drawn	draw
     dreamed	dream
     dreamt	dream
     drew	draw
     driftin'	drift
     driven	drive
     droned	drone
     dropping-in	drop-in
     drove	drive
     drunk	drink
     du	do
     duelled	duel
     duelling	duel
     dug	dig
     durst	dare
     dwelt	dwell
     dyed	dye
     eaten	eat
     ebbed	ebb
     echoed	echo
     echoes	echo
     egged	egg
     employed	employ
     enjoyed	enjoy
     enring	enring
     enveloped	envelop
     enveloping	envelop
     enwound	enwind
     erred	err
     exchanging	exchange
     excited	excite
     expressin'	express
     eyed	eye
     fallen	fall
     fast-wound	fast-wind
     fed	feed
     feed	feed
     fell	fall
     felt	feel
     fidgeted	fidget
     fit	fit
     fitted-out	fit-out
     fled	flee
     flew	fly
     fling	fling
     floodlit	floodlight
     floppin'	flop
     flown	fly
     flung	fling
     focused	focus
     focuses	focus
     focusing	focus
     focussed	focus
     focusses	focus
     focussing	focus
     forbad	forbid
     forbade	forbid
     forbid	forbid
     forbidden	forbid
     forbore	forbear
     forborne	forbear
     force-fed	force-feed
     fordid	fordo
     fordone	fordo
     forecast	forecast
     foredid	foredo
     foredone	foredo
     foregoes	forego
     foregone	forego
     foreknew	foreknow
     foreknown	foreknow
     foreran	forerun
     forerun	forerun
     foresaw	foresee
     foreseen	foresee
     foreshowed	foreshow
     foreshown	foreshow
     forespoke	forespeak
     forespoken	forespeak
     foretold	foretell
     forewent	forego
     forgave	forgive
     forgiven	forgive
     forgone	forgo
     forgot	forget
     forgotten	forget
     forsaken	forsake
     forsling	forsling
     forsook	forsake
     forswore	forswear
     forsworn	forswear
     forwent	forgo
     fought	fight
     found	find
     fraught	fraught
     fringing	fringe
     frolicked	frolic
     frolicking	frolic
     frostbit	frostbite
     frostbitten	frostbite
     frothed	froth
     frothing	froth
     froze	freeze
     frozen	freeze
     fuelled	fuel
     fuelling	fuel
     gainsaid	gainsay
     galloped	gallop
     galloping	gallop
     gan	gin
     ganged	gang
     gassed	gas
     gasses	gas
     gassing	gas
     gave	give
     gazetted	gazette
     gelled	gel
     gelling	gel
     gelt	geld
     genotyped	genotype
     gettin'	get
     ghostwritten	ghostwrite
     ghostwrote	ghostwrite
     gilt	gild
     gim	give
     ging	ging
     girt	gird
     given	give
     giveth	give
     goes	go
     goin'	go
     gon	go
     gone	go
     gossiping	gossip
     got	get
     gotten	get
     gourding	gourding
     graven	grave
     grew	grow
     gript	grip
     ground	grind
     grown	grow
     had	have
     had	have
     had	have
     hagridden	hagride
     hagrode	hagride
     half-rose	half-rise
     haloed	halo
     halterbroke	halterbreak
     halterbroken	halterbreak
     hamstring	hamstring
     hamstrung	hamstring
     hand-fed	hand-feed
     handwritten	handwrite
     handwrote	handwrite
     hanged	hang
     has	have
     hast	have
     hath	have
     have	have
     having	have
     heard	hear
     held	hold
     hewed	hew
     hewn	hew
     hid	hide
     hidden	hide
     hit	hit
     hoist	hoist
     honed	hone
     honied	honey
     hove	heave
     hung	hang
     hurt	hurt
     ignited	ignite
     igniting	ignite
     inbred	inbreed
     inbring	inbring
     inbrought	inbring
     inciting	incite
     indwelt	indwell
     infringing	infringe
     ing	ing
     inlaid	inlay
     input	input
     inset	inset
     installed	install
     installing	install
     installing	install
     interbred	interbreed
     intercut	intercut
     interfered	interfere
     interfering	interfere
     interlaid	interlay
     interpreted	interpret
     interpreting	interpret
     interset	interset
     intervened	intervene
     intervening	intervene
     interwound	interwind
     interwove	interweave
     interwoven	interweave
     inthring	inthring
     intoned	intone
     invited	invite
     inviting	invite
     inwove	inweave
     inwoven	inweave
     is	be
     jerry-built	jerry-build
     kayoed	kayo
     kent	ken
     kept	keep
     kicks-off	kick-off
     king	king
     knelt	kneel
     knew	know
     knit	knit
     know'd	know
     knowin'	know
     known	know
     ko'd	ko
     ko'ing	ko
     ko's	ko
     labeled	label
     labeling	label
     laded	lade
     laden	lade
#    laden	load
     laid	lay
     lain	lie
     landslid	landslide
     landslidden	landslide
     larkin'	lark
     lay	lie
     leant	lean
     leaped	leap
     leapt	leap
     learned	learn
     learnt	learn
     led	lead
     left	leave
     lem	let
     lent	lend
     lept	leap
     let	let
     lied	lie
     lighted	light
     lighted-up	light-up
     ling	ling
     lip-read	lip-read
     lit	light
     loggating	loggating
     longed	long
     looped-up	loop-up
     lost	lose
     lounging	lounge
     made	make
     maketh	make
     making-out	make-out
     manoeuvring	manoeuvre
     marketed	market
     meant	mean
     met	meet
     might	may
     mimicked	mimic
     mimicking	mimic
     ming	ming
     mirrored	mirror
     misbecame	misbecome
     misbecome	misbecome
     miscast	miscast
     miscut	miscut
     misdealt	misdeal
     misdid	misdo
     misdone	misdo
     misgave	misgive
     misgiven	misgive
     misheard	mishear
     mishit	mishit
     misinterpreted	misinterpret
     mislaid	mislay
     mislearnt	mislearn
     misled	mislead
     misread	misread
     missaid	missay
     missent	missend
     misset	misset
     misspelled	misspell
     misspelt	misspell
     misspent	misspend
     misspoke	misspeak
     misspoken	misspeak
     misswore	misswear
     missworn	misswear
     mistaken	mistake
     mistaught	misteach
     misthought	misthink
     mistold	mistell
     mistook	mistake
     misunderstood	misunderstand
     miswed	miswed
     miswore	miswear
     misworn	miswear
     miswritten	miswrite
     miswrote	miswrite
     molten	melt
     monitored	monitor
     monitoring	monitor
     motored	motor
     mouthed	mouth
     mouthing	mouth
     mowed	mow
     mowed/mown	mow
     mown	mow
     murmured	murmur
     murmuring	murmur
     mus	must
     nauseated	nauseate
     nonplussed	nonplus
     nonplusses	nonplus
     nonplussing	nonplus
     of	have
     offset	offset
     outbid	outbid
     outbidden	outbid
     outbred	outbreed
     outdid	outdo
     outdone	outdo
     outdrank	outdrink
     outdrawn	outdraw
     outdrew	outdraw
     outdriven	outdrive
     outdrove	outdrive
     outdrunk	outdrink
     outflew	outfly
     outflown	outfly
     outfought	outfight
     outgrew	outgrow
     outgrown	outgrow
     outlaid	outlay
     outleapt	outleap
     outmanoeuvred	outmanoeuvre
     output	output
     outran	outrun
     outridden	outride
     outrode	outride
     outrun	outrun
     outsang	outsing
     outsat	outsit
     outsaw	outsee
     outseen	outsee
     outshone	outshine
     outshot	outshoot
     outsing	outsing
     outsing	outsing
     outslept	outsleep
     outsmelt	outsmell
     outsold	outsell
     outsped	outspeed
     outspent	outspend
     outspoke	outspeak
     outspoken	outspeak
     outsprang	outspring
     outspring	outspring
     outsprung	outspring
     outspun	outspin
     outstood	outstand
     outsung	outsing
     outswam	outswim
     outswore	outswear
     outsworn	outswear
     outswum	outswim
     outthought	outthink
     outthrew	outthrow
     outthrown	outthrow
     outtold	outtell
     outwore	outwear
     outworn	outwear
     outwound	outwind
     outwritten	outwrite
     outwrote	outwrite
     overate	overeat
     overawed	overawe
     overbid	overbid
     overbidden	overbid
     overbore	overbear
     overborn	overbear
     overborne	overbear
     overbought	overbuy
     overbred	overbreed
     overbuilt	overbuild
     overcame	overcome
     overcast	overcast
     overcome	overcome
     overcut	overcut
     overdid	overdo
     overdone	overdo
     overdrank	overdrink
     overdrawn	overdraw
     overdrew	overdraw
     overdriven	overdrive
     overdrove	overdrive
     overdrunk	overdrink
     overeaten	overeat
     overfed	overfeed
     overflew	overfly
     overgrew	overgrow
     overheard	overhear
     overhung	overhang
     overlaid	overlay
     overlain	overlie
     overlay	overlie
     overleapt	overleap
     overlying	overlie
     overpaid	overpay
     overran	overrun
     overridden	override
     overrode	override
     overrun	overrun
     oversaw	oversee
     overseen	oversee
     overset	overset
     oversewed	oversew
     oversewn	oversew
     overshot	overshoot
     overslept	oversleep
     oversold	oversell
     oversowed	oversow
     oversown	oversow
     overspent	overspend
     overspilt	overspill
     overspoke	overspeak
     overspoken	overspeak
     oversprang	overspring
     overspread	overspread
     overspring	overspring
     oversprung	overspring
     overspun	overspin
     overstood	overstand
     overstrewed	overstrew
     overstrewn	overstrew
     overstridden	overstride
     overstrode	overstride
     overstruck	overstrike
     overtaken	overtake
     overthought	overthink
     overthrew	overthrow
     overthrown	overthrow
     overtook	overtake
     overwore	overwear
     overworn	overwear
     overwound	overwind
     overwritten	overwrite
     overwrote	overwrite
     owed	owe
     owing	owe
     paid	pay
     palled	pal
     palling	pal
     panicked	panic
     panicking	panic
     paralleling	parallel
     partaken	partake
     partook	partake
     pasted	paste
     pent	pen
     permeated	permeate
     permeating	permeate
     persevered	persevere
     phoned	phone
     phoning	phone
     picnicked	picnic
     picnicking	picnic
     ping	ping
     played	play
     pled	plead
     plunging	plunge
     postponed	postpone
     prebuilt	prebuild
     predid	predo
     predone	predo
     premade	premake
     prepaid	prepay
     preserv'd	preserve
     preset	preset
     preshrank	preshrink
     preshrunk	preshrink
     presold	presell
     presplit	presplit
     programmed	program
#    programmed	programme
     programmes	program
     prolonged	prolong
     proofread	proofread
     proved	prove
     proven	prove
     pudding	pudding
     punish'd	punish
     purred	purr
     put	put
     quick-froze	quick-freeze
     quick-frozen	quick-freeze
     quit	quit
     quizzes	quiz
     raised	raise
     ran	run
     rang	ring
     ranging	range
     re-cast	re-cast
     re-echoed	re-echo
     re-laid	re-lay
     re-made	re-make
     re-routing	re-route
     re-sold	re-sell
     re-told	re-tell
     read	read
     reawaken	reawake
     reawoke	reawake
     rebid	rebid
     rebound	rebound
     rebroadcast	rebroadcast
     rebuilt	rebuild
     recalled	recall
     recalling	recall
     recast	recast
     recited	recite
     reciting	recite
     recut	recut
     red	red
     redding	red
 #   redding	redden
     redealt	redeal
     redeveloped	redevelop
     redid	redo
     redone	redo
     redrawn	redraw
     redrew	redraw
     refilled	refill
     refit	refit
     reft	reave
     regrew	regrow
     reground	regrind
     regrown	regrow
     reheard	rehear
     rehung	rehang
     reknit	reknit
     relaid	relay
     relearnt	relearn
     relit	relight
     remade	remake
     remilled	remill
     reneweth	renew
     rent	rend
     repaid	repay
     reran	rerun
     reread	reread
     rerun	rerun
     reselling	resell
     resent	resend
     reset	reset
     resewed	resew
     resewn	resew
     resold	resell
     retaken	retake
     retaught	reteach
     retelling	retell
     rethought	rethink
     retold	retell
     retook	retake
     retore	retear
     retorn	retear
     retread	retread
     retrofit	retrofit
     reunited	reunite
     rewaken	rewake
     rewed	rewed
     rewet	rewet
     rewoke	rewake
     rewon	rewin
     rewore	rewear
     reworn	rewear
     rewound	rewind
     rewove	reweave
     rewoven	reweave
     rewritten	rewrite
     rewrote	rewrite
     ricocheted	ricochet
     rid	rid
     ridden	ride
     ring	ring
     risen	rise
     rived	rive
     riven	rive
     riveted	rivet
     riveting	rivet
     rocketed	rocket
     rode	ride
     rose	rise
     roughcast	roughcast
 #   rove	reeve
     rove	rive
     run	run
     rung	ring
     runneth	run
     runnin'	run
     running-on	run-in
     said	say
     saith	say
     sand-cast	sand-cast
     sang	sing
     sank	sink
     sat	sit
     saw	see
     sawed	saw
     sawn	saw
     sayin'	say
     scantling	scantling
     scythed	scythe
     seed	seed
     seen	see
     self-fed	self-feed
     self-sowed	self-sow
     self-sown	self-sow
     sent	send
     set	set
     set-up	set-up
     sewed	sew
     sewn	sew
     sha	shall
     shaken	shake
     shat	shit
     shaved	shave
     shaven	shave
     sheared	shear
     shed	shed
     shellacked	shellac
     shellacking	shellac
     shew	show
     shewed	show
     shewing	show
#    shewn	shew
     shewn	show
     shit	shit
     shod	shoe
     shoed	shoe
     shone	shine
     shook	shake
     shore	shear
     shorn	shear
     shot	shoot
     should	shall
     should	shall
     shouldest	shall
     shouldst	shall
     showed	show
     shown	show
     shrank	shrink
     shriven	shrive
     shrove	shrive
     shrunk	shrink
     shrunken	shrink
     shut	shut
     sicked	sic
     sicking	sic
     sight-read	sight-read
     sightsaw	sightsee
     sightseen	sightsee
     signed-on	sign-on
     silhouetted	silhouette
     sing	sing
     singin'	sing
     sited	site
     siting	site
     sitteth	sit
     sitting-in	sit-in
     ski'd	ski
     ski-ing	ski
     skydove	skydive
     skywritten	skywrite
     skywrote	skywrite
     slain	slay
     slept	sleep
     slew	slay
     slid	slide
     slidden	slide
     sling	sling
     slit	slit
     sloothering	sloothering
     slung	sling
     slunk	slink
     smelleth	smell
     smelt	smell
     smilin'	smile
     smit	smite
     smiting	smite
     smitten	smite
     smoothed	smooth
     smoothing	smooth
     smote	smite
     snuck	sneak
     sold	sell
     sought	seek
     sowed	sow
     sown	sow
     spake	speak
     spat	spit
     sped	speed
     spellbound	spellbind
     spelt	spell
     spent	spend
     spilled	spill
     spilt	spill
     spit	spit
     split	split
     spoilt	spoil
     spoke	speak
     spoken	speak
     sponsored	sponsor
     sponsoring	sponsor
     spoon-fed	spoon-feed
     spotlit	spotlight
     spraing	spraing
     sprang	spring
     spread	spread
     spring	spring
     sprung	spring
     spun	spin
     squilgee	squeegee
     stall-fed	stall-feed
     stang	sting
     stank	stink
     stepped-up	step-up
     stole	steal
     stolen	steal
     stoned	stone
     stood	stand
     stove	stave
     strang	string
     strewed	strew
     strewn	strew
     stricken	strike
     stridden	stride
     string	string
     string	string
     string	string
     stript	strip
     striven	strive
     strod	stride
     strode	stride
     strolling	stroll
     strove	strive
     struck	strike
     strung	string
     stuck	stick
     stung	sting
     stunk	stink
     stymying	stymie
     sub-let	sub-let
     sublet	sublet
     subpoenaed	subpoena
     sunburnt	sunburn
     sung	sing
     sunk	sink
     sunken	sink
     swam	swim
     sware	swear
     swear	swear
     sweat	sweat
     swelled	swell
     swept	sweep
     swing	swing
     swollen	swell
     swopped	swap
     swopping	swap
     swops	swap
     swore	swear
     sworn	swear
     swum	swim
     swung	swing
     tailored	tailor
     taken	take
     talcked	talc
     talcking	talc
     talkin'	talk
     targeted	target
     targeting	target
     tasted	taste
     tasting	taste
     taught	teach
     taxying	taxi
     teacheth	teach
     telecast	telecast
     telephoned	telephone
     telephoning	telephone
     tellin'	tell
     test-driven	test-drive
     test-drove	test-drive
     test-flew	test-fly
     test-flown	test-fly
     thing	thing
     thought	think
     thrang	thring
     threw	throw
     thring	thring
     thrived	thrive
     thriven	thrive
     thronged	throng
     throve	thrive
     thrown	throw
     thrung	thring
     thrust	thrust
     tilleth	till
     told	tell
     toned	tone
     took	take
     tore	tear
     torn	tear
     trafficked	traffic
     trafficking	traffic
     trailed-off	trail-off
     trameled	trammel
     trameling	trammel
     tramelled	trammel
     tramelling	trammel
     tramels	trammel
     transfixt	transfix
     tranship	transship
     traveled	travel
     traveling	travel
     travellin'	travel
     tried	try
     trod	tread
     trodden	tread
     troubleshot	troubleshoot
     tutoring	tutor
     twanged	twang
     twing	twinge
     typecast	typecast
     typed	type
     typeset	typeset
     typewritten	typewrite
     typewrote	typewrite
     typing	type
     unbent	unbend
     unbore	unbear
     unborn	unbear
     unborne	unbear
     unbound	unbind
     unbuilt	unbuild
     unclad	unclothe
     under-written	under-write
     underbid	underbid
     underbought	underbuy
     undercut	undercut
     underfed	underfeed
     undergirt	undergird
     undergoes	undergo
     undergone	undergo
 #   underlaid	underlay
     underlaid	underlie
     underlain	underlie
     underlay	underlie
     underlet	underlet
     underlied	underlie
     underlying	underlie
     underran	underrun
     underrun	underrun
     undershot	undershoot
     undersold	undersell
     underspent	underspend
     understood	understand
     undertaken	undertake
     underthrust	underthrust
     undertook	undertake
     underwent	undergo
     underwritten	underwrite
     underwrote	underwrite
     undid	undo
     undone	undo
     undrawn	undraw
     undrew	undraw
     unfroze	unfreeze
     unfrozen	unfreeze
     unheld	unhold
     unhid	unhide
     unhidden	unhide
     unhung	unhang
     united	unite
     uniting	unite
     unknit	unknit
     unladed	unlade
     unladen	unlade
     unlaid	unlay
     unlearnt	unlearn
     unmade	unmake
     unrove	unreeve
     unsaid	unsay
     unsewed	unsew
     unsewn	unsew
     unsling	unsling
     unslung	unsling
     unspun	unspin
     unstrang	unstring
     unstring	unstring
     unstrung	unstring
     unstuck	unstick
     unswore	unswear
     unsworn	unswear
     untaught	unteach
     unthought	unthink
     untying	untie
     unwound	unwind
     unwove	unweave
     unwoven	unweave
     unwritten	unwrite
     unwrote	unwrite
     upheld	uphold
     uphove	upheave
     uprisen	uprise
     uprose	uprise
     upset	upset
     used-up	use-up
     vetoed	veto
     vext	vex
     waked	wake
     wan	want
     wantin'	want
     was	be
     was	be
     wast	be
     wasted	waste
     wasting	waste
     waylaid	waylay
     weaved	weave
     wed	wed
     weed	weed
     went	go
     wept	weep
     were	be
     were	be
     wert	be
     wet	wet
     whipping-in	whip-in
     whizzed	whiz
     whizzes	whiz
     whizzing	whiz
     wing	wing
     withdrawn	withdraw
     withdrew	withdraw
     withheld	withhold
     withstood	withstand
     witnesseth	witness
     wo	will
     woke	wake
     woken	wake
     won	win
     won't	will
     wooed	woo
     wore	wear
     worn	wear
     would	will
     wouldest	will
     wouldst	will
     wound	wind
     wove	weave
     woven	weave
     wrang	wring
     wring	wring
     writing	write
     written	write
     wrote	write
     wrought	work
     wrung	wring
compound:
     bless'ee	bless|thou
     bless'ye	bless|you
     fear't	fear|it
     gimme	give|I
     gonna	go|to
     gotta	got|to
     ha'ye	have|you
     had'n	have
     i'the	in|the
     lemme	let|I
     look'ee	look|you
     look'ye	look|you
     niltow	will|thou
     o'rt	over|it
     o'ye	of|you
     t'ad	thou|have
     t'doctor	the|doctor
     t'maister	the|master
     they'le                they|will
     thou'st                thou|have
     told'em	tell|he
     told'n	tell|he
     try't	try|it
     t'were it|be
     twould it|will
     upon't upon|it
     w'ye	with|you
     wanna	want|to
     we'se	we|shall
     whaddya	what|do|you
     whatcha	what|be|you
     when't	when|it
     why't	why|it
     wi'a	with|a
     wi'ye	with|you
     y'ad	you|have
     ye'se	you|shall
